7 20
0 0 0 0 0 0 0 0 0 0 0 0 0 0 1 0 0 0 0 0
0 0 0 2 0 0 0 0 0 0 0 0 0 0 1 0 3 0 0 1
0 2 0 0 0 0 0 0 0 0 1 1 1 1 1 0 0 0 0 1
1 1 1 1 1 0 0 0 0 0 0 0 0 0 1 1 1 1 0 1
0 0 0 0 0 0 0 0 0 0 1 0 0 0 0 0 0 0 0 1
0 0 0 0 0 0 0 0 0 0 1 0 0 0 1 1 1 1 1 1
0 0 0 0 0 0 0 0 0 0 1 0 0 0 1 0 0 0 0 0
0 5 1 7
3 6 5 8